
abandoned industrial site :  Site that cannot be used for any purpose  being contaminated by pollutants. 

abandoned vehicle :  A vehicle that has been discarded in the environment  urban or otherwise  often found wrecked  destroyed  damaged or with a major component part stolen or missing. 

abiotic factor :  Physical  chemical and other non-living environmental factor.  
access road :  Any street or narrow stretch of paved surface that leads to a specific destination  such as a main highway. 

access to the sea :  The ability to bring goods to and from a port that is able to harbor sea faring vessels. 

accident :  An unexpected  unfortunate mishap  failure or loss with the potential for harming human life  property or the environment.  An event that happens suddenly or by chance without an apparent cause. 

accumulator :  A rechargeable device for storing electrical energy in the form of chemical energy  consisting of one or more separate secondary cells.\\n(Source: CED) 

acid :  A compound capable of transferring a hydrogen ion in solution.  Being harsh or corrosive in tone.  Having an acid  sharp or tangy taste.  A powerful hallucinogenic drug manufactured from lysergic acid.  Having a pH less than 7  or being sour  or having the strength to neutralize  alkalis  or turning a litmus paper red. 
acidification :  Addition of an acid to a solution until the pH falls below 7. 

acidity :  The state of being acid that is of being capable of transferring a hydrogen ion in solution. 

acidity degree :  The amount of acid present in a solution  often expressed in terms of pH. 

acid rain :  Rain having a pH less than 5.6. 

acoustic filter :  A device employed to reject sound in a particular range of frequencies while passing sound in another range of frequencies. 

acoustic insulation :  The process of preventing the transmission of sound by surrounding with a nonconducting material. 

acoustic level :  Physical quantity of sound measured  usually expressed in decibels.\\n(Source: KORENa) 

acoustic property :  The characteristics found within a structure that determine the quality of sound in its relevance to hearing.\\n(Source: KOREN) 

acoustics :  The science of the production  transmission and effects of sound. 

actinide :  An element member of the actinide group of 15 radioactive elements. 
act :  Something done voluntarily by a person  and of such a nature that certain legal consequences attach to it.  Legal documents  decrees  edicts  laws  judgments  etc.  To do something.  To perform a theatrical role. 

actinium :  A radioactive element of the actinide series  occurring as a decay product of uranium. It is used as an alpha particle source and in neutron production.\\n(Source: CED) 

action group :  A collection of persons united to address specific sociopolitical or socioeconomic concerns. 

activated carbon :  A powdered  granular or pelleted form of amorphous carbon characterized by a very large surface area per unit volume because of an enormous number of fine pores.\\n(Source: LANDY) 

activated sludge :  Sludge that has been aerated and subjected to bacterial action; used to speed breakdown of organism matter in raw sewage during secondary waste treatment.\\n(Source: LANDY) 


adaptable species :  Species capable of adapting to changing circumstances. 

chemical addition :  Chemical reaction in which one or more of the double bonds or triple bonds in an unsaturated compound is converted to a single bond by the addition of other atoms or groups. 

additional packaging :  Additional packaging around the normal sales packaging  for example as protection against theft or for the purpose of advertising. 

addition polymer :  A polymer formed by the chain addition of unsaturated monomer molecules  such as olefins  with one another without the formation of a by-product  as water; examples are polyethylene  polypropylene and polystyrene. 

additive :  A substance mixed in small quantities with another product to modify its chemical or physical state  for example to make food look visually more attractive.  Proper to be added. 

adhesive :  Substance used for sticking objects together. 

acceptable daily intake :  The measurement of the amount of any chemical substance that can be safely consumed by a human being in a day. Calculations are usually based on the maximum level of a substance that can be fed to animals without producing any harmful effects. This is divided by a \ safety factor\  to allow for the differences between animals and humans and to take account of the variation in human diets. 

administration :  The management or direction of the affairs of a public or private office  business or organization. 

administrative body :  Any governmental agency or organization charged with managing and implementing regulations  laws and government policies.\\n(Source: BLD)  All representatives in a company that have the assignment to administrate the company itself. 

administrative competence :  The power of an administrative organ to exercise control over a certain field. 

administrative fiat :  An authoritative decree  sanction or order issued from an office with executive or managerial authority  without necessarily having the force of law or its equivalent.\\n(Source: RHW / BLD) 

administrative jurisdiction :  The extent  power or territory in which an office with executive or managerial authority administers justice or declares judgments.\\n(Source: RHW / BLD) 

administrative law :  Body of law created by administrative agencies in the form of rules  regulations  orders and decisions to carry out regulatory powers and duties of such agencies.\\n(Source: BLACK) 

administrative sanction :  Any formal official imposition of penalty or fine  e.g.: destruction  taking  seizure  or withholding of property; assessment of damages  reimbursement  restitution  compensation  costs  charges or fees; requirement  revocation or suspension of license; or any other compulsory or restrictive action taken by an organization  agency or its representative. 

adsorption :  The physical or chemical bonding of molecules of gas  liquid or a dissolved substance to the external surface of a solid or the internal surface  if the material is porous  in a very thin layer. 

adult :  A person who is fully grown  developed or of a specified age.  (of animals) fully developed. 

adult education :  Any instruction or training  informal or formal  which is geared to persons of mature age  regardless of previous education  and typically offered by university extension programs  employers  correspondence courses or community groups. 

advertisement :  The action of drawing public attention to goods  services or events  often through paid announcements in newspapers  magazines  television or radio.\\n(Source: C / RHW) 

product advertising :  The creation and dissemination of paid announcements or public notices to draw attention to goods  services or events offered by some entity  usually for purchase.\\n(Source: RHW) 

advice :  Official notice  opinion  counsel or recommendation that is optional or at the receiver's discretion. 

aeration :  Exposition to the action of air. 

aerial photograph :  An image of the ground surface made on a light-sensitive material and taken at a high altitude from an aircraft  spacecraft or rocket.\\n(Source: MHD) 

aerobic process :  A process requiring the presence of oxygen. 

aerobiology :  The study of the atmospheric dispersal of airborne fungus spores  pollen grains  and microorganisms; and  more broadly  of airborne propagules of algae and protozoans  minute insects such as aphids  and pollution gases and particles which exert specific biologic effects. 

aerodynamic noise :  Acoustic noise caused by turbulent airflow over the surface of a body. 

aerosol :  A gaseous suspension of ultramicroscopic particles of a liquid or a solid.\\n(Source: MGH)  An aerosol can for applying paint  deodorant  etc.  as a fine spray. 

afforestation :  Establishment of a new forest by seeding or planting of nonforested land.  The planting of trees on land which was previously used for other uses than forestry.  The planting of trees in an area  or the management of an area to allow trees to regenerate or colonize naturally  in order to produce a forest. 

Africa :  The second largest of the continents  on the Mediterranean in the north  the Atlantic in the west  and the Red Sea  Gulf of Aden  and Indian Ocean in the east. 

afterburning :  The incineration of polluting gases and particles resulting from incompletely combusted fuel  and the breakdown of other molecules associated with combustion into inert chemicals. 

age :  The period of time that a person  animal or plant has lived or is expected to live.  To begin to look older; to get older.  To make older.  A period of history having some distinctive feature.  How long something has existed. 

agricultural biotechnology :  An advanced technology that allows plant breeders to make precise genetic changes to impart beneficial traits to crop plants. 

agricultural building :  The buildings and adjacent service areas of a farm.\\n(Source: WEBSTE) 

agricultural ecology :  Study of the ecology of agricultural systems and the natural resources required to sustain them. 

agricultural economics :  An applied social science that deals with the production  distribution  and consumption of agricultural or farming goods and services. 

agricultural engineering :  A discipline concerned with developing and improving the means for providing food and fiber for mankind's needs.\\n(Source: MGH) 

agricultural equipment :  Machines utilized for tillage  planting  cultivation and harvesting of crops. Despite its benefits in increasing yields  mechanisation has clearly had some adverse environmental effects: deep ploughing exposes more soil to wind and water erosion; crop residues can be removed as opposed to ploughing back into the soil; removal of residues can lead to a serious loss of organic content in the soil  which may increase the risk of soil erosion.\\n(Source: MGH /  DOBRIS) 

agricultural machinery :  Machines utilized for tillage  planting  cultivation and harvesting of crops. Despite its benefits in increasing yields  mechanisation has clearly had some adverse environmental effects: deep ploughing exposes more soil to wind and water erosion; crop residues can be removed as opposed to ploughing back into the soil; removal of residues can lead to a serious loss of organic content in the soil  which may increase the risk of soil erosion.\\n(Source: MGH /  DOBRIS) 

agricultural management :  The administration or handling of soil  crops and livestock. 

agricultural pest :  Insects and mites that damage crops  weeds that compete with field crops for nutrients and water  plants that choke irrigation channels or drainage systems  rodents that eat young plants and grain  and birds that eat seedlings or stored foodstuffs.\\n(Source: WRIGHT) 

agricultural policy :  A course of action adopted by government or some other organization that determines how to deal with matters involving the cultivation of land; raising crops; feeding  breeding and raising livestock or poultry; and other farming issues.\\n(Source: RHW) 

agricultural production :  The amount of grown crops and breeded livestock per year in a given area. 

agriculture :  The production of plants and animals useful to man  involving soil cultivation and the breeding and management of crops and livestock. 

agrochemical :  Any substance or mixture of substances used or intended to be used for preventing  destroying  repelling  attracting  inhibiting  or controlling any insects  rodents  birds  nematodes  bacteria  fungi  weeds or other forms of plant  animal or microbial life regarded as pests. 

agroforestry :  The interplanting of farm crops and trees  especially leguminous species. In semiarid regions and on denuded hillsides  agroforestry helps control erosion and restores soil fertility  as well as supplying valuable food and commodities at the same time.\\n(Source: ALL) 

agroindustry :  Industry dealing with the supply  processing and distribution of farm products.\\n(Source: PHC) 

agrometeorology :  The study of the interaction between meteorological and hydrological factors  on the one hand  and agriculture in the widest sense  including horticulture  animal husbandry and forestry  on the other.\\n(Source: EURMET) 

AIDS :  A disease of the human immune system caused by the human immunodeficiency virus (HIV). 

air :  A predominantly mechanical mixture of a variety of individual gases forming the earth's enveloping atmosphere.  To expose to fresh air.  To send data over the airwaves  as in radio or television.  An expression or appearance indicating a certain state of mind.  A succession of notes forming a distinctive sequence.  The space above the earth's surface where planes fly.  To expose to cool or cold air so as to cool or freshen. 

air conditioning :  A system or process for controlling the temperature and sometimes the humidity and purity of the air in a house  etc. 

aircraft :  A vehicle  designed to be supported by the air  either by the dynamic action of the air upon the surfaces of the structure or object or by its own buoyancy.\\n(Source: MGH) 

aircraft noise :  Noise caused by various sources associated with aircraft operation  such as propeller and engine exhaust  jet noise  and sonic boom. 

air movement :  Air movements within the Earth's atmospheric circulation; also called planetary winds. Two main components are recognized: first  the latitudinal meridional component due to the Coriolis force (a deflecting motion or force discussed by G.G. de Coriolis in 1835. The rotation of the Earth causes a body moving across its surface to be deflected to the right in the N hemisphere and to the left in the S hemisphere); and secondly  the longitudinal component and the vertical movement  resulting largely from varying pressure distributions due to differential heating and cooling of the Earth's surface.\\n(Source: WHIT) 

air pollutant :  Any pollutant agent or combination of such agents  including any physical  chemical  biological  radioactive substance or matter which is emitted into or otherwise enters the ambient air and can  in high enough concentrations  harm humans  animals  vegetation or material.\\n(Source: LEE /  TOE) 

air pollution :  Presence in the atmosphere of large quantities of gases  solids and radiation produced by the burning of natural and artificial fuels  chemical and other industrial processes and nuclear explosions. 

airport :  A landing and taking-off area for civil aircraft  usually with surfaced runways and aircraft maintenance and passenger facilities. 

air quality :  The degree to which air is polluted; the type and maximum concentration of man-produced pollutants that should be permitted in the atmosphere.\\n(Source: ALL /  WRIGHT) 

air quality control :  The measurement of ambient air-pollution concentrations in order to determine whether there is a problem in a given region.\\n(Source: CONFERa) 

air safety :  Any measure  technique or design intended to reduce the risk of harm posed by either moving vehicles or projectiles above the earth's surface or pollutants to the earth's atmosphere. 

amorphous silicon :  A non-crystalline semiconductor material that has no long-range order. 

flowerpot :  Container in which flowers and other plants are cultivated and displayed. 

antireflection coating :  A thin coating of a material  which reduces the light reflection and increases light transmission  applied to a photovoltaic cell surface. 

antireflection :  Preventing visible reflection. 

armored cable :  A cable provided with a wrapping of metal  usually steel wires or tapes  primarily for the purpose of mechanical protection. 

electric arc :  An electrical breakdown of a gas that produces an ongoing plasma discharge  resulting from a current through normally nonconductive media such as air. 

breakdown voltage :  (of an insulator) The minimum voltage that causes a portion of an insulator to become electrically conductive. 

electrical breakdown :  A rapid reduction in the resistance of an electrical insulator when the voltage applied across it exceeds the breakdown voltage. 

dielectric breakdown :  A rapid reduction in the resistance of an electrical insulator when the voltage applied across it exceeds the breakdown voltage. 

arc-over voltage :  The minimum voltage required to cause an arc between electrodes separated by a gas or liquid insulation. 

base load :  That part of electricity demand which is continuous  and does not vary over a 24-hour period. Approximately equivalent to the minimum daily load. 

critical mass :  The smallest amount of fissile material needed for a sustained nuclear chain reaction. 

electric power industry :  The generation  transmission  distribution and sale of electric power to the general public. 

dielectric :  An electrical insulator that can be polarized by an applied electric field. 

dielectric material :  An electrical insulator that can be polarized by an applied electric field. 

electric field :  A component of the electromagnetic field. 

electromagnetic field :  A physical field produced by electrically charged objects. 

dustproof :  Resistant to dust. 

failproof :  Resistant to failure. 

fail-safe :  That doesn't cause undue damage  in the event of failure.  Equipped with a secondary system that insures continued operation even if the primary system fails. 

failsafe :  That doesn't cause undue damage  in the event of failure.  Equipped with a secondary system that insures continued operation even if the primary system fails. 

electrical grid :  An integrated system of electricity distribution  usually covering a large area. 

electric line truck :  A truck used to transport personnel  tools  and material for electric supply line work. 

truck-mounted crane :  A truck with a chassis built-in crane  used to load and unload goods in the truck itself  or to move the goods within the range of the crane. 

crawler crane :  A crane mounted on an undercarriage with a set of Caterpillar tracks that provide stability and mobility. 

tower crane :  A type of balance crane made of a detachable metal structure  powered by electricity  specially designed to work as a tool in building. 

bridge crane :  A type of crane where the hook-and-line mechanism runs along a horizontal beam that itself runs along two widely separated rails. 

overhead crane :  A type of crane where the hook-and-line mechanism runs along a horizontal beam that itself runs along two widely separated rails. 

citric :  Of  pertaining to  or derived from lemon. 

absorbability :  The state or quality of being absorbable. 

impracticable :  Incapable of being put into practice or accomplished; not feasible. 

deskfast :  A breakfast eaten at work  particularly while sitting at a desk. 

personal :  Of or pertaining to a particular person.  (grammar) Denoting a person. 

put to the proof :  to check a property or quality of 

per :  For each. 

piezoelectricity :  The electric charge that accumulates in certain solid materials in response to applied mechanical stress. 

piezoelectric :  Of or relating to piezoelectricity. 

piezoelectric effect :  The ability of certain materials to generate an electric charge in response to applied mechanical stress. 

gravitational :  Pertaining to  or caused by  gravity or gravitation. 

ferroelectric :  Of  or relating to the permanent electrical polarization of a crystalline dielectric in an electric field. 

ferroelectricity :  A property of certain materials that have a spontaneous electric polarization that can be reversed by the application of an external electric field. 

luminescence :  Any emission of light that cannot be attributed merely to the temperature of the emitting body. 

incandescence :  A physical phenomenon manifested by a light emission due to the temperature of a heated body. 

piezoluminescence :  A form of luminescence created by pressure upon certain solids. 

fluorescence :  The emission of light by a substance that has absorbed light or other electromagnetic radiation. 

frictional :  Relating to  or caused by  friction. 

frictional unemployment :  (economics) A type of unemployment explained by people being temporarily between jobs  searching for new ones. 

structural unemployment :  A form of unemployment where  at a given wage  the quantity of labor supplied exceeds the quantity of labor demanded. 

fuel injection :  A system for admitting fuel into an internal combustion engine. 

exhaust system :  System consisting of the parts of an engine through which burned gases or steam are discharged. 

catalytic :  (chemistry) Having properties facilitating chemical reaction or change. 

transgender :  Having a gender which is the different from one's natal sex. 

eurozone :  A monetary union of 19 European Union (EU) member states that have adopted the euro (\u20ac) as their common currency and sole legal tender. 

euro area :  A monetary union of 19 European Union (EU) member states that have adopted the euro (\u20ac) as their common currency and sole legal tender. 

poo-bus :  A bus powered bybiomethane natural gas made from animal waste. 

toroidal :  Having the shape of a torus or toroid. 

scientific theory :  A well-substantiated explanation of some aspect of the natural world that is acquired through the scientific method and repeatedly tested and confirmed through observation and experimentation. 

scientific method :  A body of techniques for investigating phenomena  acquiring new knowledge  or correcting and integrating previous knowledge. 

pseudoscience :  A claim  belief or practice which is incorrectly presented as scientific  but does not adhere to a valid scientific method  cannot be reliably tested  or otherwise lacks scientific status. 

Palmyra :  (historical) an ancient Aramaic oasis-city in Syria  on the site of present-day Tadmor. 

Crimean Federal District :  One of the nine federal districts of Russia  established on March 21  2014 after the annexation of Crimea by the Russian Federation. 

streaming media :  Multimedia that is constantly received by and presented to an end-user while being delivered by a provider. 

acetic acid :  An acid with the chemical formula CH3COOH found typically in vinegar. 

ethanoic acid :  An acid with the chemical formula CH3COOH found typically in vinegar. 

Atrato :  A river of northwestern Colombia which rises in the slopes of the Western Cordillera and flows almost due north to the Gulf of Urab\u00e1 (or Gulf of Dari\u00e9n)  where it forms a large  swampy delta. 

oil well :  A boring in the Earth that is designed to bring petroleum oil hydrocarbons to the surface. 

flammability :  The ability of a substance to burn or ignite  causing fire or combustion. 

flash point :  The lowest temperature at which a volatile material can vaporize to form an ignitable mixture in air. 

fire point :  The temperature at which the vapour produced by a fuel will continue to burn for at least 5 seconds after ignition by an open flame. 

kindling point :  The lowest temperature at which a substance will spontaneously ignite in a normal atmosphere without the need of an external source of ignition  such as a flame or spark. 

autoignition temperature :  The lowest temperature at which a substance will spontaneously ignite in a normal atmosphere without the need of an external source of ignition  such as a flame or spark. 

autoignition :  Spontaneous ignition. 

gas field :  A field containing natural gas but no oil. 

natural gas field :  A field containing natural gas but no oil. 

gas injection :  The process whereby separated associated gas is pumped back into a reservoir for conservation purposes or to maintain the reservoir pressure. 

liquefied natural gas :  Oilfield or naturally occurring gas  chiefly methane  liquefied for transportation. 

life-lie :  An untrue belief that someone clings to in order to make life bearable. 

grand delusion :  An untrue belief that someone clings to in order to make life bearable. 

hydration :  (biology) The process of providing an adequate amount of water to body tissues. 

rehydration :  The replenishment of water and electrolytes lost through dehydration. 

rehydrate :  To restore water that has been removed or lost; to moisten something that has dried. 

hydrate :  To take up  consume or become linked to water.  A solid compound containing or linked to water molecules. 

Natasha :  Female Russian first name. 

echo chamber :  A hollow enclosure used to produce reverberated sounds  usually for recording purposes.  A situation in which information  ideas  or beliefs are amplified or reinforced by transmission and repetition inside an \ enclosed\  system  where different or competing views are censored  disallowed or otherwise underrepresented. 

anechoic chamber :  A room designed to completely absorb reflections of either sound or electromagnetic waves. 

filter bubble :  A personalized search in which a website algorithm selectively guesses what information a user would like to see based on information about the user (such as location  past click behavior and search history) and  as a result  users become separated from information that disagrees with their viewpoints  effectively isolating them in their own cultural or ideological bubbles. 

disinformation :  Intentionally false or inaccurate information that is spread deliberately. 

Cunibert :  Male first name. 

non-insurable :  Not capable of being insured. 

per stirpes :  By representation or class. 

per capita :  By total number of individuals. 

protective cover :  Object that holds something to protect it. 

offshore :  Located in the sea away from the coast. 

Phinehas :  Character of the Old Testament  ancient Hebrew priest (son of Eleazar  himself son of Aaron) known for having killed together an Israelite man and a Midianite woman in order to combat idolatry spreading among Israelites committing sexual immorality with foreign women. 

Phineas :  Character of the Old Testament  ancient Hebrew priest (son of Eleazar  himself son of Aaron) known for having killed together an Israelite man and a Midianite woman in order to combat idolatry spreading among Israelites committing sexual immorality with foreign women. 

Phinees :  Character of the Old Testament  ancient Hebrew priest (son of Eleazar  himself son of Aaron) known for having killed together an Israelite man and a Midianite woman in order to combat idolatry spreading among Israelites committing sexual immorality with foreign women. 

everyone is different :  Proverb telling that people tend to be unique individuals having their own quirks each  little or profound. 

silver lining :  A good aspect of a mostly bad event. 

ossuary :  A small container that holds the bones of a deceased person.  A place for holding the bones of the dead. 

barge :  A large flat-bottomed towed or self-propelled boat used mainly for river and canal transport of heavy goods or bulk cargo. 

wanderlust :  A strong desire to travel around the world. 

hash :  The result of a computation during which from a large set of data a small figure or few characters are determined that change  when the data changes. 

parry :  To impede the movement of (an opponent or a ball). 

open source software :  Software that everyone is free to copy  redistribute and modify. 

palagonite :  An alteration product from the interaction of water with volcanic glass of chemical composition similar to basalt. 

dutch door :  A door having two separate blades or parts  located above and below one another  the upper of which usually can be opened and closed independently from the other which most often can be moved only together with the upper part. 

tensor muscle :  A muscle that stretches a body part  or renders it tense. 

holoalphabetic sentence :  A sentence which contains every letter of the alphabet only once.  A sentence which contains every letter of the alphabet at least once. 

plant science :  A branch of the biological sciences which embraces the study of plants and plant life. 

plant sciences :  A branch of the biological sciences which embraces the study of plants and plant life. 

drink coaster :  A flat object on which beverages are put to protect the surface of a table. 

beverage coaster :  A flat object on which beverages are put to protect the surface of a table. 

beermat :  A flat object on which beverages are put to protect the surface of a table. 

email boilerplate :  The always identical final part of an e-mail. 

staff duty soldier in the orderly room :  A soldier working in an orderly room. 

locked :  Of a door  etc.  that has been locked (usually with a key). 

West Arawe :  An Austronesian dialect chain of West New Britain  Papua New Guinea. 

arawe occidental :  An Austronesian dialect chain of West New Britain  Papua New Guinea. 

fronton :  The terminal part of the facade of a building - especially the classical temples - usually triangular. 

Gb\u00e0n\u00f9 :  A Gbaya language of the Central African Republic. 

Banu :  A Gbaya language of the Central African Republic. 

Gbanou :  A Gbaya language of the Central African Republic. 

Gbanzili :  A Ubangian language of the Central African Republic and the Democratic Republic of the Congo. 

Dagaga :  A Papuan language spoken by approximately 30 000 people of Fataluku ethnicity in the eastern areas of East Timor  especially around Lospalos and a dialect of it  Oirata  is spoken in Kisar  Moluccas in Indonesia. 

Dagada :  A Papuan language spoken by approximately 30 000 people of Fataluku ethnicity in the eastern areas of East Timor  especially around Lospalos and a dialect of it  Oirata  is spoken in Kisar  Moluccas in Indonesia. 

Dagoda' :  A Papuan language spoken by approximately 30 000 people of Fataluku ethnicity in the eastern areas of East Timor  especially around Lospalos and a dialect of it  Oirata  is spoken in Kisar  Moluccas in Indonesia. 

Yat\u00ea :  An isolated language of Brazil  and the only indigenous language remaining in the northeastern part of that country. 

find out :  To discover through asking or exploring. 

switchboard :  An electrical device consisting of an insulated panel containing switches and dials and meters for controlling other electrical devices. 

caucus :  A colleection of persons that were assigend a specific task  most often for a predetermined time  or to be completed within a given time frame  that is to find or determine something  make decisions  or steer towards a settlement that other are looking for and/or are going to use. 

board  :  A colleection of persons that were assigend a specific task  most often for a predetermined time  or to be completed within a given time frame  that is to find or determine something  make decisions  or steer towards a settlement that other are looking for and/or are going to use. 

Comission :  A colleection of persons that were assigend a specific task  most often for a predetermined time  or to be completed within a given time frame  that is to find or determine something  make decisions  or steer towards a settlement that other are looking for and/or are going to use. 

inlay :  Something filling up a gap or covering up a (small) distance. 

panelling :  Something put around something else  usually in order to give it another look or to protect it from its environment. 

casing :  Something put around something else  usually in order to give it another look or to protect it from its environment. 

facing :  Something put around something else  usually in order to give it another look or to protect it from its environment. 

lining :  Something put around something else  usually in order to give it another look or to protect it from its environment. 

assumption of Mary :  Catholic holiday on August 15  remembering the day when the Virgin Mary  Christ's mother  went to Heaven. 

auscultation :  Listening to the heart and lungs using a stethoscope. 

